af - Afrikaans
ar - Arabic
bg - Bulgarian
bn - Bengali
ca - Catalan,Valencian
cs - Czech
cy - Welsh
da - Danish
de - German
el - Greek
en - English
es - Spanish, Castilian
et - Estonian
fa - Persian
fi - Finnish
fr - French
gu - Gujarati
he - Hebrew
hi - Hindi
hr - Croatian
hu - Hungarian
id - Indonesian
it - Italian
ja - Japanese
kn - Kannada
ko - Korean
lt - Lithuanian
lv - Latvian
mk - Macedonian
ml - Malayalam
mr - Marathi
ne - Nepali
nl - Dutch,Flemish
no - Norwegian
pa - Punjabi
pl - Polish
pt - Portuguese
ro - Romanian,Moldavian,Moldovan
ru - Russian
sk - Slovak
sl - Slovenian
so - Somali
sq - Albanian
sv - Swedish
sw - Swahili
ta - Tamil
te - Telugu
th - Thai
tl - Tagalog
tr - Turkish
uk - Ukrainian
ur - Urdu
vi - Vietnamese
zh-cn - Chinese PRC
zh-tw - Chinese Taiwan